1111111111111111111111111111
1000000010000000000000000001
1000000010000000000000000001
1000000010000000000000000001
1000000010000000000000000001
1000000010000000000000000001
1000000010000000000000000001
1000000010000000000000000001
1000000010000000000000000001
1000000011111111110000000001
1000000000000000010000000001
1000000000000000010000000001
1000000000000000010000000001
1000000000000000010000000001
1000000000000000010000000001
1000000000000000010000100001
1000000000000000010000100001
1000000000000000011111100001
1000000000000000000000000001
1000000000000000000000000001
1000000000000000000000000001
1000000000000000000000000001
1000000000000000000000000001
1000000000000000000000000001
1000000000000000000000000001
1000000000000000000000000001
1000000000000000000000000001
1111111111111111111111111111