    ####################################
#   ####################################
#   ####################################
#                                    ###
####   ###############   ###############
####   ###############   ###############
####   ###############   ###############
####          ########   ###############
###########   ########   ###         ###
###########   ########   ###         ###
###########                          ###
########################################