    ####################################
#   ####################################
#   ####################################
#                                    ###
####   ################  ###############
####   ################  ###############
####   ################  ###############
####          #########  ###############
###########   #########  ###         ###
###########   #########  ###         ###
###########                         ####
########################################