    ##################################
#   ##################################
#   ##################################
#      ###############################
####   ###############################
####   ###############################
####   ###############################
####          ########################
###########   #############         ##
###########   #############    $    ##
###########                         ##
######################################